111111111111111
10010000EC00001
1P0100000000011
111111111111111
