111111111111111
10010000EP00001
1C0100000000011
111111111111111
