111111111111111
111111110111111
1000000PEC00001
111111110111111
111111111111111
