111111111111111
1E100CP00000001
111111111111111
