111111111
1000EC011
111111111
