1111111111
1000000PE1
1111111111
