1111111111111
1F010000000C1
1000011111E01
1P10110000001
1111111111111