111111111
1000ECP01
1000000011
111111111
