111111111
1000ECP01
100000000
111111111
