111111111
1000ECPP1
100000001
111111111
