11111
10001
11001
1PEC1
11111
