111111111
1000ECPE1
100000001
111111111
