111111111111111111111
1E1000000010000010001
101110111010111010101
101000100010001010101
101011101111101010101
10100010000010100F101
10101011111C101111101
1010100010001010F0101
101111101011111010101
100C0000100C000P10001
111111111111111111111