111111111
100000C01
1E0011001
100000001
100010F01
111000001
100F00C01
100000001
10001P101
111111111